60 -1 20 20 20 20 20 20 20
50 1000 -1 -1 -1 -1 -1 -1 -1
30 500 5 5 5 5 5 5 5
20 -1 10 -1 -1 -1 10 -1 10
10 200 -1 -1 -1 -1 -1 -1 -1
40 600 15 15 15 15 15 15 15
100 2000 40 40 40 40 40 40 40
25 -2 5 10 15 -1 -1 -1 15
35 600 20 15 10 5 -1 -1 15
30 -1 40 30 30 -1 -1 -1 -1